000000000000
011111111110
010000000010
010000000010
011111011110
000011011000
000011011000
011111011110
010000000010
010000000000
011111111110
000000000000